11111111111111111111111
1P000C00000000000000001
100000000000000C0000001
100000010000C0000C00001
10011C01000011100000001
10000001000000011110001
100C0000001000010E00001
11111111111111111111111

