1111111111111
1P00000000001
1110011111C01
100011EC00001
1111111111111
