1111111111111
1P000000000C1
1000011111C01
100011E000001
1111111111111
