1111111111111
1PC00000000C1
1110011111C01
100011E000001
1111111111111
