1111111111111
1P001100000E1
10001000100C1
1C00010000001
1111111111111


