11111111111111111111111111111111111
1000000C000100000000000000000000001
100011010001CCCC1111111111111111111
1CE0000C00C000000000000000111111111
100011010P0000000000000000000000001
11111111111111111111111111111111111
