111111111111
1P00000C0001
100011010001
1C00000C00E1
100011010001
111111111111
