111111
1P0C01
10E0C1
1E00C1
110011
